NO ./textures/north.xpm
WE  ./textures/west.xpm




C    255,0,012
EA  ./textures/east.xpm

SO ./textures/south.xpm

F                                 123,123,123

 111111111111111111111111111
1100000000000000000000000001
100E00000000000000000000000111111111
 10000000000000000000000000100000001
 10000000000001100000000000000000011
 1000000000000000000000000011111111
 100000000000000000000000001
 100000000000000000000000001
 100000001000010000000000001
 100000000000000000000000001
 100000000000000000000000001
 100000000000000000000000001
 100000000000000000000000001
 100000000000000000000000001
 100000000000000000000000001
 100000000000000000000000001
 100000000000000000000000001
 100000000000000000000000001
 100000000000000000000000001
 100000000000000000000000001
 100000000000000000000000001
 100000000000000000000000001
 100000000000000000000000001
 100000000000000000000000001
 100000000000000000000000001
 100000000000000000000000001
 100000000000000000000000001
 100000000000000000000000001
 100000000000000000000000001
 100000000000000000000001111
 100000000000000000000000001
 111111111111111111111111111

