NO ./textures/north.xpm
WE  ./textures/west.xpm




C    255,0,012
EA  ./textures/east.xpm

SO ./textures/south.xpm
F                                 123,123,123

111111111111111111111111111
100000000000000000000000001
10E000000000000000000000001
100000000000000000000000001
100000000000011000000000001
100000000000000000000000001
100000000000000000000000001
100000000000000000000000001
100000001000010000000000001
100000000000000000000000001
100000000000000000000000001
100000000000000000000000001
100000000000000000000000001
100000000000000000000000001
100000000000000000000000001
100000000000000000000000001
100000000000000000000000001
100000000000000000000000001
100000000000000000000000001
100000000000000000000000001
100000000000000000000000001
100000000000000000000000001
100000000000000000000000001
100000000000000000000000001
100000000000000000000000001
100000000000000000000000001
100000000000000000000000001
100000000000000000000000001
100000000000000000000000001
100000000000000000000000001
100000000000000000000000001
111111111111111111111111111