NO ./e
WE awdawd




C    255,0,012
EA adadada

SO awdawd
F 123,123,123

111111111
100000001
111111E11
100000001
111111111