NO ./e
WE awdawd




C    255,0,012
EA adadada

SO awdawd
F 123,123,123

111111111
1E0000001
111111011
100000001
111111111