NO ./e
WE awdawd




C    255,0,012
EA adadada

SO awdawd
F 123,123,123

1111111111111111111
1E00000    00000001
1111110111111111111
100000001
101110001
101 1 001
101110001
100000001
100000001
100000001
100000001
111111111